11111111111111111
1C0000000000000C1
111001010CP000001
10100100CEC010101
100000000C00C0001
11111111111111111
